1 1 1 1 1 1 1 1
1 1 1 1 1 1 1 1 8 8 8 8
1 0 0 0 0 0 0 0 8 4 4 8
1 1 1 1 1 1 1 1 8 8 8 8
1 1 1 1 1 1 1 1
